time	n
year	n
people	n
way	n
man	n
day	n
thing	n
work	n
child	n
government	n
other	j
good	j
new	j
old	j
great	j
say	v
get	v
make	v
see	v
go	v
know	v
take	v
come	v
look	v
think	v
